ISO-3	Language Name	Script Name
mda	Mada	Latin
nin	Ninzo	Latin
odu	Odual	Latin
abn	Abua	Latin
ego	Eggon	Latin
kyq	Kenga	Latin
bdh	Baka	Latin
eka	Ekajuk	Latin
bza	Bandi	Latin
bfa	Bari	Latin
aha	Ahanta	Latin
box	Bwamu / Buamu	Latin
wbi	Vwanji	Latin
mwe	Mwera	Latin
asa	Asu	Latin
bem	Bemba / Chibemba	Latin
beq	Beembe	Latin
bez	Bena	Latin
bxk	Bukusu	Latin
cce	Chopi	Latin
chw	Chuabo	Latin
cjk	Chokwe	Latin
cwe	Kwere	Latin
dav	Dawida / Taita	Latin
dhm	Dhimba	Latin
dig	Chidigo	Latin
diu	Gciriku	Latin
dug	Chiduruma	Latin
ebu	Kiembu / Embu	Latin
eko	Koti	Latin
fip	Fipa	Latin
flr	Fuliiru	Latin
gog	Gogo	Latin
guz	Ekegusii	Latin
gwr	Gwere	Latin
hay	Haya	Latin
jit	Jita	Latin
jmc	Machame	Latin
kam	Kikamba	Latin
kck	Kalanga	Latin
kdc	Kutu	Latin
kde	Makonde	Latin
kdn	Kunda	Latin
kik	Gikuyu / Kikuyu	Latin
kin	Kinyarwanda	Latin
kiz	Kisi	Latin
kki	Kagulu	Latin
kmb	Kimbundu	Latin
kng	Kongo	Latin
koo	Konzo	Latin
kqn	Kikaonde	Latin
ksb	Shambala / Kishambala	Latin
kua	Oshiwambo	Latin
kuj	Kuria	Latin
kwn	Kwangali	Latin
lai	Lambya	Latin
lam	Lamba	Latin
lgm	Lega-mwenga	Latin
lik	Lika	Latin
mck	Mbunda	Latin
mer	Kimiiru	Latin
mgh	Makhuwa-Meetto	Latin
mgq	Malila	Latin
mgr	Mambwe-Lungu	Latin
mgw	Matumbi	Latin
mws	Mwimbi-Muthambi	Latin
myx	Masaaba	Latin
nba	Nyemba	Latin
nbl	IsiNdebele	Latin
ndc	Ndau	Latin
nde	IsiNdebele	Latin
ndh	Ndali	Latin
ndj	Ndamba	Latin
ndo	Ndonga	Latin
ngl	Lomwe	Latin
ngo	Ngoni	Latin
ngp	Ngulu	Latin
nih	Nyiha	Latin
nim	Nilamba / kinilyamba	Latin
nka	Nkoya / ShiNkoya	Latin
nnq	Ngindo	Latin
nse	Chinsenga	Latin
nso	Sepedi	Latin
nuj	Nyole	Latin
nya	Chichewa	Latin
nyd	Olunyole / Nyore	Latin
nyf	Giryama	Latin
nyk	Nyaneka	Latin
nym	Nyamwezi	Latin
nyn	Nyankore / Nyankole	Latin
nyo	Nyoro	Latin
nyu	Nyungwe	Latin
nyy	Nyakyusa-Ngonde / Kyangonde	Latin
poy	Pogolo / Shipogoro-Pogolo	Latin
rag	Lulogooli	Latin
rim	Nyaturu	Latin
rnd	Uruund	Latin
rng	Ronga / ShiRonga	Latin
rub	Gungu	Latin
run	Rundi / Kirundi	Latin
rwk	Rwa	Latin
sbp	Sangu	Latin
sbs	Kuhane	Latin
sby	Soli	Latin
sna	Shona	Latin
sng	Sanga / Kiluba	Latin
sop	Kisonge	Latin
sot	Sesotho	Latin
ssw	Siswati	Latin
suk	Sukuma	Latin
swa	Swahili	Latin
swc	Swahili Congo	Latin
swh	Swahili	Latin
swk	Sena, Malawi	Latin
sxb	Suba	Latin
thk	Tharaka	Latin
tke	Takwane	Latin
tlj	Talinga-Bwisi	Latin
tog	Tonga	Latin
toh	Gitonga	Latin
toi	Chitonga	Latin
tsc	Tshwa	Latin
tsn	Setswana	Latin
tso	Tsonga	Latin
ttj	Toro / Rutoro	Latin
tum	Chitumbuka	Latin
umb	Umbundu	Latin
ven	Tshivenda	Latin
vid	Chividunda	Latin
vif	Vili	Latin
vmk	Makhuwa-Shirima	Latin
vmw	Macua	Latin
vun	Kivunjo	Latin
wmw	Mwani	Latin
xho	Isixhosa	Latin
xog	Soga	Latin
yao	Yao / Chiyao	Latin
yom	Ibinda	Latin
zaj	Zaramo	Latin
zdj	Comorian, Ngazidja	Latin
zga	Kinga	Latin
ziw	Zigula	Latin
zul	Isizulu	Latin
mwn	Cinamwanga	Latin
loz	Silozi	Latin
lsm	Saamya-Gwe / Saamia	Latin
lto	Tsotso	Latin
lua	Tshiluba	Latin
lue	Luvale	Latin
lug	Luganda	Latin
lun	Lunda	Latin
lwg	Wanga	Latin
dwr	Dawro	Latin
gmv	Gamo	Latin
gof	Goofa	Latin
wal	Wolaytta	Latin
bci	Baoulé	Latin
cko	Anufo	Latin
fat	Fante	Latin
nzi	Nzema	Latin
sfw	Sehwi	Latin
twi	Twi	Latin
heh	Hehe	Latin
her	Herero	Latin
pem	Kipende	Latin
pkb	Kipfokomo / Pokomo	Latin
dib	Dinka, South Central	Latin
dik	Dinka, Southwestern	Latin
dip	Dinka, Northeastern	Latin
dks	Dinka, Southeastern	Latin
nus	Nuer	Latin
dow	Doyayo	Latin
kmy	Koma	Latin
gkn	Gokana	Latin
ogo	Khana	Latin
kqy	Koorete	Latin
fuh	Fulfulde, Western Niger	Latin
fuq	Fulfulde Central Eastern Niger	Latin
fuv	Fulfulde Nigeria	Arabic
fub	Fulfulde, Adamawa	Latin
gna	Kaansa	Latin
kbp	Kabiye	Latin
kdh	Tem	Latin
lee	Lyélé	Latin
mzw	Deg	Latin
nnw	Nuni, Southern	Latin
ntr	Delo	Latin
sig	Paasaal	Latin
sil	Sisaala, Tumulung	Latin
tpm	Tampulma	Latin
xsm	Kasem	Latin
vag	Vagla	Latin
acd	Gikyode	Latin
naw	Nawuri	Latin
ncu	Chunburung	Latin
nko	Nkonya	Latin
idu	Idoma	Latin
ige	Igede	Latin
yba	Yala	Latin
bqj	Bandial	Latin
csk	Jola Kasa	Latin
jib	Jibu	Latin
nnb	Nande / Ndandi	Latin
kln	Kalenjin	Latin
pko	Pökoot	Latin
krx	Karon	Latin
kia	Kim	Latin
cme	Cerma	Latin
akp	Siwu	Latin
lef	Lelemi	Latin
lip	Sekpele	Latin
snw	Selee	Latin
kdj	Ng’akarimojong	Latin
lot	Latuka	Latin
mas	Maasai	Latin
saq	Samburu	Latin
teo	Teso	Latin
tuv	Turkana	Latin
adh	Jopadhola / Adhola	Latin
alz	Alur	Latin
anu	Anyuak / Anuak	Latin
kdi	Kumam	Latin
laj	Lango	Latin
lth	Thur / Acholi-Labwor	Latin
luo	Dholuo / Luo	Latin
lwo	Luwo	Latin
mfz	Mabaan	Latin
shk	Shilluk	Latin
ach	Acholi	Latin
mpe	Majang	Latin
mcu	Mambila, Cameroon	Latin
bam	Bambara	Latin
dyu	Jula	Latin
knk	Kuranko	Latin
msc	Maninka, Sankaran	Latin
mfg	Mogofin	Latin
mnk	Mandinka	Latin
nza	Mbembe, Tigon	Latin
kbn	Kare	Latin
kzr	Karang	Latin
tui	Toupouri	Latin
xuo	Kuo	Latin
men	Mende	Latin
bex	Jur Modo	Latin
mgc	Morokodo	Latin
bcn	Bali	Latin
mzm	Mumuye	Latin
agq	Aghem	Latin
azo	Awing	Latin
bav	Vengo	Latin
bbj	Ghomálá'	Latin
bbk	Babanki	Latin
bfd	Bafut	Latin
bmo	Bambalang	Latin
bmv	Bum	Latin
byv	Medumba	Latin
jgo	Ngomba	Latin
lmp	Limbum	Latin
mgo	Meta'	Latin
mnf	Mundani	Latin
ngn	Bassa	Latin
nla	Ngombale	Latin
nnh	Ngiemboon	Latin
oku	Oku	Latin
yam	Yamba	Latin
ybb	Yemba	Latin
mdm	Mayogo	Latin
mbu	Mbula-Bwazza	Latin
gjn	Gonja	Latin
buy	Bullom So	Latin
gya	Gbaya, Northwest	Latin
bss	Akoose	Latin
bum	Bulu	Latin
dua	Douala	Latin
eto	Eton	Latin
ewo	Ewondo	Latin
iyx	yaka	Latin
khy	Kele / Lokele	Latin
kkj	Kako	Latin
koq	Kota	Latin
ksf	Bafia	Latin
lin	Lingala	Latin
mcp	Makaa	Latin
ngc	Ngombe	Latin
nxd	Ngando	Latin
ozm	Koonzime	Latin
tll	Otetela	Latin
tvu	Tunen	Latin
won	Wongo	Latin
yat	Yambeta	Latin
lem	Nomaande	Latin
loq	Lobala	Latin
ibb	Ibibio	Latin
efi	Efik	Latin
ann	Obolo	Latin
bfo	Birifor, Malba	Latin
bim	Bimoba	Latin
biv	Birifor, Southern	Latin
bud	Ntcham	Latin
bwu	Buli	Latin
dag	Dagbani	Latin
dga	Dagaare	Latin
dgd	Dagaari Dioula	Latin
dgi	Dagara, Northern	Latin
gng	Ngangam	Latin
gur	Farefare	Latin
gux	Gourmanchema	Latin
hag	Hanga	Latin
kma	Konni	Latin
kus	Kusaal	Latin
maw	Mampruli	Latin
mfq	Moba	Latin
mos	Moore	Latin
soy	Miyobe	Latin
xon	Konkomba	Latin
mwm	Sar	Latin
myb	Mbay	Latin
bjv	Bedjond	Latin
gqr	Gor	Latin
gvl	Gulay	Latin
ksp	Kabba	Latin
lap	Laka	Latin
sba	Ngambay	Latin
ndz	Ndogo	Latin
lnl	Banda, South Central	Latin
bun	Sherbro	Latin
gso	Gbaya, Southwest	Latin
mur	Murle	Latin
did	Didinga	Latin
tex	Tennet	Latin
vut	Vute	Latin
tcc	Datooga	Latin
kno	Kono	Latin
vai	Vai	Vai
tul	Kutule	Latin
bst	Basketo	Ethiopic
ffm	Fulfulde, Maasina	Latin
fue	Fulfulde, Borgu	Latin
fuf	Pular	Latin
zne	Zande / paZande	Latin
guw	Gun	Latin
amh	Amharic	Ethiopic
bsp	Baga Sitemu	Latin
bzw	Basa	Latin
nhu	Noone	Latin
avu	Avokaya	Latin
kbo	Keliko	Latin
lgg	Lugbara	Latin
log	Logo	Latin
luc	Aringa	Latin
xnz	Mattokki	Latin
uth	u̱t-Hun	Latin
kyf	Kouya	Latin
ijn	Kalabari	Latin
okr	Kirike	Latin
shj	Shatt	Latin
lro	Laro	Latin
mkl	Mokole	Latin
yor	Yoruba	Latin
bin	Edo	Latin
ish	Esan	Latin
etu	Ejagham	Latin
fon	Fon	Latin
ful	Fulah	Latin
gbr	Gbagyi	Latin
atg	Ivbie North-Okpela-Arhe	Latin
krw	Krahn, Western	Latin
wec	Guéré	Latin
har	Harari	Latin
igl	Igala	Latin
ktj	Krumen, Plapo	Latin
ted	Krumen, Tepo	Latin
asg	Cishingini	Latin
kdl	Tsikimba	Latin
tsw	Tsishingini	Latin
xrb	Karaboro, Eastern	Latin
kqs	Kisi	Latin
gbo	Grebo, Northern	Latin
lom	Loma	Latin
anv	Denya	Latin
ken	Kenyang	Latin
mfi	Wandala	Latin
mev	Maan / Mann	Latin
ngb	Ngbandi, Northern	Latin
fia	Nobiin	Latin
nwb	Nyabwa	Latin
mdy	Maale	Ethiopic
ebr	Ebrié	Latin
sef	Sénoufo, Cebaara	Latin
iri	Rigwe	Latin
izr	Izere	Latin
kcg	Tyap	Latin
spp	Sénoufo, Supyire	Latin
myk	Sénoufo, Mamara	Latin
dyi	Sénoufo, Djimini	Latin
sev	Sénoufo, Nyarafolo	Latin
tgw	Sénoufo, Tagwana	Latin
tem	Timne	Latin
tiv	Tiv	Latin
sgw	Sebat Bet Gurage	Latin
dnj	Dan	Latin
wol	Wolof	Latin
fak	Fang	Latin
sor	Somrai	Latin
bwr	Bura Pabir	Latin
kqp	Kimré	Latin
daa	Dangaléat	Latin
mmy	Migaama	Latin
hbb	Nya huba	Latin
aba	Abé / Abbey	Latin
adj	Adjukru  / Adioukrou	Latin
ati	Attié	Latin
avn	Avatime	Latin
nyb	Nyangbo	Latin
tcd	Tafi	Latin
bba	Baatonum	Latin
bky	Bokyi	Latin
bom	Berom	Latin
etx	Iten / Eten	Latin
gud	Dida, Yocoboué	Latin
igb	Ebira	Latin
ada	Dangme	Latin
gaa	Ga	Latin
ewe	Éwé	Latin
gol	Gola	Latin
yre	Yaouré	Latin
ibo	Igbo	Latin
ikk	Ika	Latin
ikw	Ikwere	Latin
iqw	Ikwo	Latin
izz	Izii	Latin
klu	Klao	Latin
gkp	Kpelle, Guinea	Latin
xpe	Kpelle	Latin
bov	Tuwuli	Latin
ajg	Aja	Latin
krs	Gbaya	Latin
xed	Hdi	Latin
niy	Ngiti	Latin
afr	Afrikaans	Latin
knf	Mankanya	Latin
moy	Shekkacho	Latin
iso	Isoko	Latin
oke	Okpe	Latin
urh	Urhobo	Latin
sus	Sosoxui	Latin
yal	Yalunka	Latin
bsc	Oniyan	Latin
cou	Wamey	Latin
wib	Toussian, Southern	Latin
moa	Mwan	Latin
ttr	Nyimatli	Latin
kub	Kutep	Latin
hau	Hausa	Latin
bcw	Bana	Latin
kvj	Psikye	Latin
giz	South Giziga	Latin
gnd	Zulgo-gemzek	Latin
maf	Mafa	Latin
meq	Merey	Latin
mfh	Matal	Latin
mfk	Mofu, North	Latin
mif	Mofu-Gudur	Latin
mlr	Vame	Latin
mqb	Mbuko	Latin
muy	Muyang	Latin
hna	Mina	Latin
bcy	Bacama	Latin
gde	Gude	Latin
moz	Mukulu	Latin
bib	Bisa	Latin
bqc	Boko	Latin
bus	Bokobaru	Latin
ndv	Ndut	Latin
snf	Noon	Latin
byf	Bété	Latin
lia	Limba, West-Central	Latin
mlg	Malagasy	Latin
tir	Tigrinya	Ethiopic
rif	Tarifit	Arabic
sbd	Samo, Southern	Latin
nhr	Naro	Latin
lmd	Lumun	Latin
shi	Tachelhit	Latin
gid	Gidar	Latin
xan	Xamtanga	Ethiopic
hgm	Hai|ǁom	Latin
sid	Sidama	Latin
kab	Kabyle	Latin
xtc	Katcha-Kadugli-Miri	Latin
kby	Kanuri, Manga	Latin
kri	Krio	Latin
wes	Pidgin, Cameroon	Latin
pcm	Nigerian Pidgin	Latin
naq	Khoekhoe	Latin
thv	Tamahaq, Tahaggart	Latin
gax	Oromo, Borana-Arsi-Guji	Ethiopic / Latin
gaz	Oromo, West Central	Ethiopic / Latin
orm	Oromo	Ethiopic / Latin
rel	Rendille	Latin
aar	Afar / Qafar	Latin
som	Somali	Latin
taq	Tamasheq	Latin
ttq	Tawallammat	Latin
dsh	Daasanach	Latin
mcn	Masana / Massana	Latin
mpg	Marba	Latin
bds	Burunge	Latin
ses	Songhay, Koyraboro Senni	Latin
cop	Coptic	Coptic
ber	Berber	Latin
crs	Seychelles Creole	Latin
mfe	Morisyen / Mauritian Creole	Latin
ktu	Kikongo	Latin
sag	Sango	Latin
kea	Kabuverdianu	Latin
pov	Guinea-Bissau Creole	Latin
